4 7 8259 8239 8260 8240 8245 8232 8218 
3 8 8445 3406 2347 8420 1425 607 2648 8427 
2 13 8879 8849 3581 4636 8764 8728 8673 3534 431 8616 435 3682 5411 
1 4 435 8625 1879 8670 
3 2 2776 8879 
2 4 8829 1279 8799 8800 
2 5 5495 3482 8587 8585 3682 
3 10 8445 8465 2841 8515 3819 5553 5495 8629 8603 8650 
3 6 8445 3146 1923 8406 5131 8377 
3 12 1280 2759 4591 4047 4592 3962 4891 1568 449 2478 8382 8377 
3 15 1929 4805 4788 139 3276 8358 8343 4194 8301 8335 8323 8297 5347 8246 8218 
3 5 8323 1792 1407 8410 8427 
3 7 139 3837 8414 2987 8368 767 8346 
2 4 2987 1459 1298 8474 
3 8 8368 5474 8214 8177 8155 2046 2167 8154 
3 5 2046 1647 4953 4129 2988 
2 11 2988 7992 1409 3845 7966 7945 984 4039 3031 4258 7900 
4 3 8259 8276 8260 
1 2 8276 8239 
3 10 8218 2900 8234 1722 8151 8130 8107 8082 4657 8122 
3 6 4657 8063 8032 2293 7963 7960 
3 8 7960 1414 7906 7841 1251 7758 7739 7705 
3 10 7906 1657 3555 4248 7954 1494 7961 7964 2761 7998 
2 9 7998 4330 2400 7974 1313 2733 4889 8011 8043 
1 2 8048 5595 
3 9 2613 2387 8447 2088 4085 3583 1997 8348 4979 
2 9 2387 3787 4983 8396 595 8401 8415 3026 1843 
2 15 8287 3556 8200 8184 1757 8252 8293 5057 74 8327 551 8242 4288 8186 8152 
1 3 7996 4715 8051 
1 3 2580 7898 7887 
1 4 7662 7653 7637 7629 
1 2 7588 7593 
1 9 2471 3545 6588 315 1450 1817 5175 3692 2618 
2 8 6682 1949 6708 6699 4353 4329 4170 1307 
3 12 4159 6741 6682 5339 1639 6600 523 2618 1601 1090 2133 1307 
1 11 1090 2 4273 4368 1262 4564 5644 6232 1127 5279 3723 
3 3 1206 3912 3167 
2 3 3167 1973 1872 
2 7 1872 7196 4491 1003 1680 621 6914 
2 2 6617 6640 
2 5 5349 939 8555 856 8591 
3 4 8479 2879 2859 8578 
2 11 3439 8195 1095 1803 3707 5200 8366 2740 8429 807 8479 
1 12 1803 3136 1806 1698 1068 3322 460 47 659 1685 3981 8014 
3 15 8479 2234 8457 408 1195 8413 699 8331 5651 4312 4835 2079 349 8064 8014 
4 7 5163 411 5511 1531 2568 2657 7609 
2 12 7609 7656 182 3597 1866 1584 2994 5301 7895 7923 1889 8014 
3 12 7696 4850 7707 4303 4880 4776 7789 7846 1296 2667 554 8014 
3 9 3242 1587 2781 7311 7301 852 7255 5470 1794 
2 8 4132 7318 4238 7305 7285 292 4938 7160 
2 5 7285 1884 2505 7329 2781 
1 10 4909 7358 7390 1135 788 7420 3861 7411 4190 1587 
1 6 4238 2790 4827 55 750 3101 
1 7 3242 7430 242 4686 7416 2438 750 
3 8 3242 4117 5399 7459 1141 3233 4003 851 
2 13 4433 7692 2598 7599 602 7583 7589 7572 700 7570 7550 3817 851 
2 7 4186 8041 3114 8095 8127 8166 8182 
2 8 4186 14 189 4633 3261 36 7885 4295 
2 7 4633 1991 7843 3144 2084 7740 4433 
2 5 5449 5211 1899 6836 6872 
2 8 5449 6873 3947 6849 6855 6805 4289 6648 
2 12 4867 5605 2341 738 6345 6401 4344 6541 4678 6654 106 5449 
2 13 5605 2922 6240 6225 6203 448 2149 6222 6251 172 2595 3811 1371 
2 3 172 3426 3418 
2 2 8259 1084 
2 9 604 3604 8278 4987 5129 8403 8417 8437 3962 
2 4 1307 4795 6478 5240 
2 10 6790 4641 4934 6764 6772 6779 6783 6806 2219 6780 
3 8 6780 3851 6837 6856 6905 1649 4607 7007 
3 11 5240 6417 1527 5615 4266 585 2005 6694 6746 6780 6807 
1 6 6752 4681 2356 420 1505 5240 
1 11 4327 7110 3007 7097 1564 6991 6929 3713 1064 6752 6699 
2 8 4327 7096 4876 4394 4638 7081 3508 7007 
1 9 6790 3029 5441 6812 4400 4958 6652 969 2378 
1 4 2378 5169 6402 257 
1 8 257 3906 3877 124 2899 2727 6272 5605 
1 3 4392 6289 6240 
1 4 6225 6180 2491 2236 
1 12 1013 5004 43 5219 6148 6138 3382 6121 6117 6131 6134 2236 
1 5 6218 2019 609 6162 6148 
1 4 1013 6187 488 609 
1 7 6187 6190 3472 2854 1002 4971 388 
1 5 3723 3987 2866 6172 388 
1 5 257 3746 4669 4376 2854 
2 10 6417 2892 6328 1709 2233 1017 1919 915 3455 3746 
1 4 585 2490 5650 1919 
2 5 1709 6305 2760 4052 3723 
1 4 6218 6239 6276 2899 
1 6 6648 4483 32 1683 1396 3906 
4 3 3193 3392 6192 
1 6 9182 3563 3606 1519 3939 5327 
1 12 2321 5123 9132 9137 4478 2732 9146 9139 9149 9156 3530 9182 
1 5 5327 9042 2527 9089 4478 
1 5 1519 712 3479 831 4306 
1 5 4306 3266 651 1642 3127 
1 10 3127 1706 8980 3360 4328 8840 1763 8763 1374 2921 
1 12 8980 1320 8968 2180 9056 698 4734 9005 8993 3559 2601 3841 
1 4 3841 573 2710 1093 
1 5 1093 4874 1907 17 5251 
1 7 2243 8886 3140 359 67 8845 17 
1 7 2243 8954 739 1905 401 5487 922 
1 4 9181 3617 3928 922 
1 2 5487 3928 
1 9 9181 9206 1179 9195 9214 9228 1143 9229 9251 
1 9 573 4877 1110 9117 1211 9193 1530 9248 9251 
1 6 1211 4476 709 9285 2927 2154 
1 5 709 943 9277 3143 9248 
1 7 4306 9070 1533 3198 9172 389 2971 
1 4 389 2175 9167 620 
1 7 620 9127 3265 713 5481 1927 9056 
1 7 2321 9202 9218 1627 9250 9256 3524 
1 5 3524 3095 1982 3112 980 
1 2 3095 9250 
1 4 980 9078 3758 2757 
1 6 980 4604 9094 2816 9054 9036 
1 6 2321 9148 2404 1410 4172 8997 
1 4 2404 4227 1716 980 
1 10 8997 925 4578 9037 9033 2911 5006 3225 5317 5327 
1 7 9284 9291 4844 3773 2751 3289 2971 
1 5 3289 2486 9302 3872 615 
1 7 615 5502 9371 9368 9344 9314 9284 
1 7 8182 8201 1818 1614 1597 1308 3573 
1 10 3573 4526 1162 3130 1860 7950 468 1070 2320 7915 
1 6 1162 1695 3551 997 2704 4295 
1 8 7915 5044 4981 3627 2358 2675 1132 7696 
3 10 2358 901 3433 4632 1027 7535 1265 7477 755 7430 
2 11 1070 1681 7848 3973 5357 1480 4223 2313 3980 3033 3817 
1 7 698 5132 3943 630 8756 8692 8775 
1 3 2243 4350 8837 
1 11 3140 1304 8837 3566 8792 211 4613 4817 3764 8669 8647 
1 4 4817 362 103 8563 
1 7 1823 8687 8665 4263 871 2803 8647 
1 8 871 692 5655 8497 1969 4901 8448 8416 
1 6 1969 3903 8455 941 1787 8563 
1 8 941 194 8441 477 8269 1366 2272 8134 
1 13 3597 7751 1727 7687 2260 3744 3983 5372 7579 7563 4021 2178 2107 
1 9 3229 4600 3457 282 7507 273 3068 7521 2107 
1 4 3133 169 3172 707 
2 10 3088 4654 2877 4044 1715 3557 72 6674 1925 3133 
1 6 3557 6578 3767 6383 3215 1556 
1 4 1556 6245 1043 6205 
1 6 7101 2724 101 2103 6784 707 
1 5 7101 2218 7073 643 2503 
3 30 3193 1297 1510 6273 96 6316 3325 6375 6426 4860 6513 3131 5326 1760 458 4584 2345 2503 5570 3532 4568 3301 6817 6789 736 6710 6709 5440 2471 1639 
1 12 3193 1187 5401 6129 6128 2226 911 3385 4030 160 6110 6105 
1 9 6105 4424 4308 6099 2864 6089 1491 6080 6086 
1 6 6086 4325 6090 6083 6078 6075 
1 4 6068 4920 6081 6075 
2 10 3088 5555 6645 4337 1089 1644 6410 5102 4417 6436 
1 10 4417 556 3924 6248 3205 3933 1231 1856 6201 1202 
1 8 1202 1289 973 6198 2095 6254 929 5033 
1 3 973 2151 3399 
1 8 3399 5314 2513 1493 6145 2472 6154 1741 
1 3 2095 2464 1493 
1 11 1741 361 6202 6214 1275 6199 3091 2274 1841 553 10426 
1 10 7473 406 7389 808 3614 333 1 7194 2252 7143 
1 6 7473 662 7515 2534 817 3677 
1 6 3677 3710 7448 2024 7395 1942 
1 14 1942 5115 1059 735 7205 3125 1401 1735 4061 7252 7277 193 7270 2348 
1 11 1942 195 7308 4160 7295 3854 7320 4871 1160 7332 7337 
1 11 1310 8198 3027 8140 8108 8079 2883 8065 8021 190 3441 
1 7 3441 1054 2126 801 3836 1227 4737 
1 16 2126 2960 7793 176 1522 2670 2655 3298 2331 956 91 7444 7415 945 7341 7337 
1 13 2882 5425 5155 8976 8987 8990 8992 152 9020 4092 4694 9122 1886 
1 3 785 687 1886 
1 12 5597 4811 9267 9261 805 9312 9339 9364 2386 1990 419 9418 
1 8 45 2609 2002 2451 9664 9690 2330 9691 
1 14 9691 4902 5427 2205 9698 5225 3342 3077 2492 4379 1022 9541 252 9538 
1 4 9319 9309 9322 2962 
1 7 9556 940 9609 3740 9694 9695 9722 
1 2 2399 8126 
1 3 7618 7625 7610 
1 8 6585 4076 6524 2951 5652 6419 6468 6423 
1 9 5963 5540 5968 5258 4013 5908 5902 1350 5898 
1 6 5810 5826 5829 5854 2150 5898 
1 7 5733 5750 5756 5781 5804 5791 5810 
1 12 5810 1175 5795 1857 5758 5778 3061 305 5796 5811 5818 5834 
1 3 5865 5859 5823 
1 5 5823 2682 5807 5785 5770 
1 6 2682 5801 5837 5822 2969 4714 
1 7 5930 678 5853 4628 3008 5821 4714 
1 9 4428 6005 5992 5981 4515 5958 5952 3053 5923 
1 2 5858 5391 
1 11 4428 6006 2907 5994 5466 1554 4947 5955 5917 5330 5887 
1 8 10316 1992 3258 10306 4046 10259 1044 10256 
1 3 10078 10061 10040 
1 9 10122 2945 764 10156 10163 243 3438 10196 10172 
1 14 3037 2405 10185 201 10208 4126 10168 10165 10167 10182 10174 5478 10173 10169 
1 7 9979 972 2449 10057 10105 10155 10185 
1 15 2531 9997 9985 2659 4530 4733 9967 2538 9975 10006 9988 9996 10022 1770 10057 
1 9 10176 10151 10130 10110 995 10088 10087 4722 2531 
1 3 1386 10186 5351 
1 3 10009 10029 10053 
1 3 10065 10046 10053 
1 6 411 4732 7470 1892 3253 7440 
1 8 4880 7647 51 2793 4026 1066 982 7440 
1 2 51 4495 
1 5 5357 2204 5420 2810 4632 
1 7 6640 1759 4107 6622 412 2735 4678 
10 4 3137 8584 8567 5349 
10 4 8599 8584 8545 8578 
3 8 3974 3427 7146 2606 2120 4470 7060 10381 
2 11 6436 1677 179 1867 6675 2546 5287 1365 6649 1369 10360 
1 9 6530 5471 346 6637 1621 6628 6678 1980 197 
1 10 7205 3231 7080 2211 2912 638 4431 648 5237 346 
4 12 7273 564 1482 1774 7291 1694 3213 4909 7321 7293 1794 2719 
4 12 2719 809 7235 3988 7176 7136 1744 7059 3414 6987 6901 563 
2 7 6901 2483 4221 4614 6827 1389 6710 
2 8 3301 2351 7005 1214 7093 7127 2384 7255 
2 11 7545 3063 7526 7517 7514 7490 2112 7462 7442 7424 1135 
3 12 7545 5346 7504 7487 3387 7439 7400 7379 7348 7317 564 7273 
4 8 10381 6975 10382 10383 10385 10386 744 7149 
4 21 7149 10388 7143 10389 7140 10392 10394 7141 10395 10399 10400 540 10403 4271 10405 6999 10406 10410 10414 10415 197 
4 15 197 10416 10417 6561 6536 6514 10418 10419 10422 10423 6498 10424 10426 10427 10430 
4 14 10430 889 6867 10431 10432 10433 6388 1189 10363 6507 10362 6590 10361 10360 
4 12 10360 9348 9293 10366 10368 10369 6876 10372 10374 10375 10379 10381 
6 9 10381 7061 2914 5190 6997 5415 3942 6895 3624 
6 11 10360 2303 599 6711 8752 6722 1791 2512 2948 1150 6781 
6 22 7143 7114 7076 7034 4101 6976 6945 6915 1703 6860 6834 2421 6747 6715 1042 6658 6630 6606 4764 3567 2141 10426 
5 2 385 10363 
6 19 197 6712 6763 1230 6724 6749 10450 6744 6770 6787 6795 3683 6788 10460 10462 6801 6810 6735 6834 
8 9 6976 10446 3388 3624 10443 10440 6781 10437 6630 
8 15 6630 10436 10435 6627 10452 1888 10450 6802 10449 6878 10448 6977 10447 5548 6976 
6 9 5548 4782 6959 6922 6907 6896 1703 6859 6840 
6 6 6922 6917 2718 4746 4396 10448 
6 9 4746 6877 6902 2699 6770 6754 167 6677 6669 
6 7 1042 2789 6716 5121 6700 6656 6669 
6 5 3624 6824 6840 6820 6834 
6 6 6840 8691 6766 6727 6695 6658 
6 5 6658 4759 6676 6671 6656 
8 7 6735 6845 10459 6775 6861 10458 3683 
8 7 3683 6762 6748 6723 10453 3654 6735 
6 7 6775 6786 6821 10462 850 6769 6723 
3 6 10448 6908 6913 6938 1314 6982 
5 2 7105 540 
5 4 5957 5944 2082 5865 
5 3 2082 5915 5957 
1 3 7196 119 7261 
1 4 1680 7084 3607 5134 
1 5 7261 4601 1971 7364 4858 
1 12 6914 4771 6871 6854 610 1276 3866 1345 6651 1495 2373 6617 
1 3 124 6355 1021 
